1111111111111111111111111111111111
1C0CCCCCCCCCCCCCCCCCCCCCCCCCCCC0P1
11CCC0CCCCCCCCCCCCCCCCCCCCCCCCC001
11CCCCCCC0CCCCCCCCCCCCCCC0CCCCCCC1
1E0CCCCCCCCCCCCCCCCCCCCCC000000001
1111111111111111111111111111111111